#.##########.###########.####################.###########.#################.
#...........#...........#....................#...........#.................#
#..######...#..######...#.....############...#########...#..###......###...#
#..#........#..#.....#..#..#..#...........#..............#..#..#..#..#.....#
#..#..#######..#.....#..#..############...#..#############..#..#..##########
#..#..#........#..#..#..#..............#.....#.................#...........#
#..#..#...##...#..####..#..#########...#..####..###.####################...#
#..#..#.....#..#.....#..#..#........#..#..#.X#..#..#.......................#
#..#..#######..#...###..#..######...#..#..#..#..#..#..#########.########...#
#..#...........#........#...........#..#..#..#..#..#..#........#........#..#
#..##################...#############..#..#..#..#..#..#..###...#..###...#..#
#....................#..............#..#.....#..#..#..#..#.....#..#..#..#..#
#..###############...############...#..#######..#..#..#..#######..#..#..#..#
#..#..............#..#...........#..#........#..#..#..#..............#..#..#
#..#..#########...#..#..######...#..######...#..#..#..################..#..#
#..#..#........#..#..#..#.....#..#..#........#..#..#.................#.....#
#..#..######...#..#..#..#.....#..#..#..#######..#..###############...#######
#..#...........#..#..#..#..#..#..#..#..#........#.................#........#
#..#############..#..#..#..#..#..#..#..#..#######..############...###......#
#.................#..#..#..#..#..#..#..#..#........#...........#..#..#..#..#
###################..#..#..#..#..#..#..#..#..###...#...#####...#..#..#..#..#
#....................#..#..#..#..#..#..#..#..#..#..#........#..#..#..#..#..#
#..#########...#######..#..#..#..#..#..#..#..#..#..#..#######..#..#..#..#..#
#..#...........#.....#..#..#.....#..#..#..#.....#..#..#........#.....#..#..#
#..#############.....####..#######..#..#..###...#..####..###...###...#..#..#
#.................#..#.................#..#..#..#..#.....#........#..#..#..#
#..######.#########..#...#####....##...#..#..#..#..#...############..#..#..#
#..#.....#...........#........#.....#..#..#.....#..#.................#..#..#
#..###...#..######...###################..#...###..###################..#..#
#........#..#.....#..#....................#.....#..#....................#..#
######...#..#...###..#..############.############..#..###.###############..#
#.....#..#..#.....#..#..#...........#..............#..#..#.................#
#.....#..#..#.....#..#..#########...###...######...#..#..#..############.###
#..#..#..#..#..#.....#..#.................#.....#..#..#..#..#...........#..#
#..####..#..##########..#.....###...#######...###..#..#..#..#......##...#..#
#.....#..#.................#..#.....#..............#..#.....#..#.....#.....#
#.....#..######.#######################....#########..###...######...#######
#..#..#..#.....#.......................#...........#..#..#........#........#
#..#..#..#.....#..##################...#############..#..###.##...#..###...#
#..#..#..#..#..#..#.................#.................#.....#..#..#..#..#..#
#..####..#..####..#..##############################.###.....#..#..#..#..#..#
#........#.....#..#..#.............................#.....#..#..#..#..#..#..#
#..#######.....#..#..#..#########.#####...######...#.....#..#..#..#..#..#..#
#..#........#..#..#..#..#........#.....#..#.....#..#..#..#..#..#..#..#..#..#
#..##########..#..#..#..#........###...#..#...###..#..#..#..#..#..#..#..#..#
#...........#..#..#..#..#..#..#........#..#........#..#..#.....#..#..#..#..#
#########...#..#..#..#..####..##########..#...######..#..#######..#..#..#..#
#........#..#..#..#...........#........#..#........#..#...........#.....#..#
#...######..#..#..#############...##...#..##########..######....#########..#
#..............#....................#..#....................#..............#
#####################################..#####################################