#############..#
#.....#........#
#..####..#..####
#........#..#..#
##########..#..#
#...........#..#
#..#..####..#..#
#..#.....#.....#
#..##########..#
#..#........#..#
#..#..####..#..#
#.....#.....#..#
#..####..####..#
#.....#..#.....#
#######..#######